#################################
#                               #
#  ##########  ########   ###   #
#  ##########  ########  #####  #
#  ###    ###  ###  ###  #####  #
#         ###  ########  #####  #
#  ##########       ###   ###   #
#  ###              ###   ###   #
#  ##########  ########         #
#  ##########  ########    #    #
#                               #
#################################